6
f 3
g 1
G 2
h 4
m 7
r 5
100 100
m G r g g g m G g m G h h m m G r m r G r h g g r G h G g m r m G G G G G g r g g g r g g h h G m m r r r h G G G m G r m r G g G g h h G g G m G h r h h r h r r m r m r r G h g h g G h r h h h m h h 
r G g m m G G m r r h G g m m m h g m h g h G r r G G r g g m r h h h m h m h h h r r r G h g m r h g h m m r m G m r m g g m m r G m G G g g G g h m r G h G g g g h h g r h h r r r m r m G m G h h h 
G g r g m G G g g g r h g m m g g h h m r m r h h r g G h m G m g G r m g G h m r h m G g h h h G G r r G g r g G r m G G G G h g h g g G m r m G h r g m m g g G r m r h g h r g m r h g g r r m r m h 
m m r g G r h m h G h r m m m m G g G G r G G G r G h h G G m G h h r h G r m m r G r g g r G g g g h m G h h G m m G m g h g G m r G m h G G g r m m r G h g m r G g m h G h m m h G g m m h g G h h r 
G g m m m m m m G g g G r r h h G G G G G m h r G r h G G G m g r r m G g m h m G G g m G g G G G G g r g G h r g g h G m m r h g m g h g g h G G r r g G g h G G G G r r G g h r r G h m r m G r m h m 
r h m m h r r m m G g r r m G G g r m h r G h r r h h r r g r G r r h G h m g g r G g G m h h m r h r r g r m m m G G h r m r h h m r G G m r r g m m g m G h m G g m m h m r r r m g g r m h G r G h G 
g g g h r G r G r h G h h g r h m h r h G r h G g h m m m G G G G h g g r m m G r G G m h g m m r m m r m r h m h m r h r G r G r m h r g g h g G g m g G h h m G r h m g G h m r g m r r g g m g h m h 
g G m g G r g m r G r g r r h r g r r G g m G m G G r r g m h r m m m r G m r m g h G G G r h m m m r m G m r h h g g g G m r m g r r G r g r r r g G g r g g h r m g h g r G r G m h G g g h r G r r h 
g r h g r G m h h g g r g G r g G g h g h h h r h g h h h h g g g m r r m h h r r m g g h m m m g m g m m r h h G g m r g h g m g G h g g G m G G g h g r g h m h r g G m r G G G h r g g r h g G G h h 
r r m h G r h g g g G G m m G m m G r r h G g g g G r m m m G h r g h r r r G h g h m G r r m g m h r m G G r r g h g G r m r r m r m h h r h h m G r h g h G m h g r m G g r r g h r r G m m m g m G G 
g r h r g m r g h G h h m r r h h r g h r g r g g G m r m h r h G h g G r r m r h h r h g G g g G G m g r m m r m h g r r r G g G h h r G r m g h h r G g r G g g m h G G m m r h m m r m G g h h g r h 
g r h h G r g G h r h g G h g m h h r G h g r r h g g r G g G G G G G r g m h G G m r g m G G g h h h r g G h G G m G r m r G m r h g G h g G r g G G G G r r G g h r h G h r m r h g G g g r h m m r h 
r m g h m r h g G m m m G G r g h m r h r g g r g h r g r g g G h G h G g r g G G r g r r G G h h g h h g g h g m r m h h g G G h G m G m g m m g g m r g g m G G r g G G r m g r h g m r G h G h m h g 
h g h h h r r m G r r m r m h r m h G m r G r r m h m r h m G g h g r G m h h G g G h h h g g m G h r h r h G g G G r m G h g h G r h r h m m G G g G r m r g g g m h m g g m G g G r h h G G h g h h h 
h m r m G G h m m m h G m h m h g G G m h G G h g G G m G g m G g r g m h r m r r g g m G g r h m m h m g h h h m h m G g m G r r G G g g g h h h r r m r h G m g m G m m G G h m m g h h m G r r G G m 
G g h h r g G r r r m m m g r h G g r G G g g h r h r g g r r m r g m r r g G g h m h m r G m m G h G r g G g G m m m h g m g g m m g r h r G g g r G g G h G m h m r h r G G m G h h r G r h G h r r r 
h g m h m m g h h m r m h m m m G G r r g G G g h r m G G g r m m G m m r g G r G h g G r g m g m h m r r r m m r h r r G h h g r m G m m r m h m m h r G h h G h m r g g r g m h m r r m g m G h G g r 
G r G G g g h r r r G G g m h r G G G g h r h r r r m m h m r r r h G m G G m g r G r G r g G g r r h m r m G r h r r r G m h m G m m G m r m m m h h r g r m g m r m r g h m m m G m m r h g G G h r m 
m g r m G r h g m r G m m G G g h m m m h h r G g G r G G h m g G r h m h G m g h r r m g r g h h h h g r h r G m h h g g h m G m r h G r G m g r g m g G m g G r m r h g G r r G r g h m G g g h h g g 
G r r h r r r h r m r G g r G G m m r G G h h h G g G h m G G m h G G h G g g G m G r h r m G h m m G G h h G h h m r m r G G m r r m m r h g m m h h m g g m g m g h g G g r G r g g g h r G h m G g h 
G m h m r G g h h g h G h h m h m r m h m G m r m G m r h G G g g h g r r h h r r G h g h m h h g G r g G G m r g G g g r m h g r m g h r r m h h m G r g m g G g g m g G G m g g g m r g m g G G m r r 
m m r G G r G h r g G G r G h m G g h g g r h G h G m G r m m g g G m r h G g h G h h h m r h g m g h g h r m r h r h r g G G r r g h G g G g G h h h m r r g h m G r G h h m r G m G g m G g h m h r G 
g G g G h m r G m h G h r g r h m h m G m g G G m r g m h g m r r G g g r g G g h g r G h g g r g G r g m G m g h h r h m g g G g m G g m h G h g g h h g G m r m h G r m G h G g m r g r g r g h h g g 
h h G g m m m r h g r h G m g h g m h m r m r g h G r g m g G h h h h r h h h g g g h m r h h m G m r G G h h g g r r m G G r m h h G m g h m h m m r G h m r r g g g G h g r r r m r m r h h r g h m m 
r m G G r g G r h m g h g h h r G r G g h r r G h g G m G r G G G m m m g h m g G m m G g g G m m h r r h m h g G g g h h g m g G h G h G g m g h m m m r r h g r r g g m h h m g m m r G h g m g G G h 
G m G G r r G G G m g m G h G G g h g h r r h r m h m r h m G m m g r r r h h g g G m g G h r r r r g h G g h G m G h h G m g r r G h m m r m m m r h h g h m g m G g h r h h h h G m m h m m m G g G r 
m r h h G G h G h m m m r h g r G r g m G g G G r g m m h g r r h m h g G g G G m g m h h m r r m g m G m g r r g r G G g r G g G g G g h g m r G h h h m m h m m r r h h m h r g m g r r h m G G r g r 
m h r h m m G m g m m r g h h m r r r m h g m m r m r g r g h r g g r g r h h G m h m h G h m m h h G m r h m G r h h G h g r r g m G g h h r G r r h G h h G m r g m m m g G G g m G r g G g r g m h g 
r m m G h g h g r g h m r g r g g g g G m g r r h G g r G g m m G r m g m g G m r m h h m r G r h m h G G h r r r G g g r G r r h r m r G G g r m g m m g g g r h G m g G g G G h g m r r h r r r G m g 
h m h g r g r g g g G r h m r r m g m g m G g g m m r h g g G r m h g h g h g m g m r g h G h g h h m m g G G G h h g G m h g m G G m h m g G r g r g h h m h m r g m m g g m m G G G r G g G m g h G m 
G G r g r G r m m h g m r m g G G h m m m g G m m g G h r g g m h h G g G h h g h r g h r r h G h g g h g g G r m h h g g g h h G m G g m h r h m h r g G m h m g G g r r r G G r h g h r m G m r G G m 
g m h r g h G h m G h m r r h h h G m h h h m G r h m g r m G h h g m G m g G h r r g g G h G m h r m h G h G m m h G r G G r m m g r G h g h r m g g G m m G G g g G m G h h g r h m r G g g m G g h h 
r h m h g G h g r G r g g r g g r h r G r G h g g G g h h m G h m g h G h g r g G r g G r r g g h G h g h h m G r G G h h g g m g h h r r m r m m r g g h g h h g G G h G G g m r G m h G r h h g h g g 
r r r G m G r r G h h g g r g r h g h h G h g m g g h g g g h m G G r g g G r g m g G m m r h r r g m r g r G m h g h r g h g G r r g m h h m h m r h h h g r r g G g r r m r m h m h h h r h m g G r h 
G G h r r r h g m G g g r g g h g m G h G g h h G h G r G g G h r m m r g G m h r h g G r G r m G h G G m G h g r h m g m r m h g m r G m g r G r G G m G h m G G m m r g r r h r m r r m g G h g r h r 
G m m r h h m r h G G h h g h h h m m r r g r G m g g r g r m h g r h m G r h g m h h r G m g G h r g m m G g r m h r m G g h h r G r G r m r m G m m r g h r r m h m r m r G r m G m h m G r g r G m g 
r G r m m r h h h h G h g g m G r m h m h h h m h m g g h m h g g r r r g m r g m m g r r h h G m m h G m g g G r m m G g m g G g g G h h h m g m G m h r m G G h r h m G h h r r m h m G g r m g r m G 
r r G m h m h m r g G g r h g m G h G G G g G m h m r g m G G g h m r h m m g h G g h h g r m g m m r m g r h h h h h h g m m m m m g r g g m g G r r g m G r h m G m g h m r g m G g r m h g g g G g G 
h h m r m g r r g h G G G h h m h g g G r g g h g r r g g G m G g h g r r r G G g G m g g h h g h G h G h g h h r r g G g r h G r r h h G m g G r r g g m g G G g h m g g g g m g m g h m m m r r h g g 
G G g m g h m g h h m g h m g m g r G h G h r h h r G r h G m h h g h h m g G g m g h r G h g G m G m g h h g h G r m g m G g g h r r m m g h g G g m h g r G G g m m m g r G h h G G g m m m h m G g g 
r g m r r G h h m r r G h r m g r m g r r G r m g m g r G m r h m r m m r m m r G r h g m g G r r g G r m G m G g G G h G h m h r G g G h h r h G G h h r m g r m G g g h G h r h m h G g r G r G G r m 
r h g r h g G m G G h G G h r h r m g r m G m m r h h m r h r r g G G r r m r h r r m h r r m r G h g g h h m h m r g G m h G r g m g G G r h h h r h r r G r G r g h g h r r m r h r h h r g g m m h m 
G h h m g g m g m h g r r h m g m h g h r r g m g r G G h G m r g G m G r G h g g r h g g G r h m h r g g m m g r h r h h h m g G h h m r r G m g g m g g h G G h r g r g m r G h m r h m h r g h G r h 
r h r G h g m G m h g m r r g r m h r g G r g m r r g r G h G h h r G m h m G r G m G m G G g h h g m g h g G g m h G h m g r G G G m G m r r g r r h m r m h r r m G m g h h h m G m G m h h g m G r g 
g m m g m r m g m h r m g r g r g G h r r h g G m h m h m g g G r G r r m m r g G r h g r G r g m r h G r g G r r G G G r r m h r h G g m r h h G m g m m m r r h m g r m m m m h G m h G r G h h h m g 
r m h G G m m g m G r g G g r g G r G h m m G h r m m h h r m m G m r g r h r h m g g g g m g h h m h h m r m m h g g g m g h G r m g g G h g m m g m G r G m g g G g m m h h h m G G r r h m r h h h g 
G m g G g g g g h r m m r r r h g G h G h r r h r r h m g h g r m r m h g g h g m m g h h r r h r r m h h r h m h r m G h m m r m r G r r m h g m r G G r r g m r m h G m r h h r m r m m r G m h r m G 
h m m m G r m r r m G r h G r r G m g g G h G g r g h h h h r r r g h m h g h r g g g h m m m r m r g h G h g g g m h h r r G m m g m m h G g m h r h m h h m h G g m m h m r r r g G h h G r r g G g m 
h h h g m G g m r h g m G g G g m m g h m m G r G g G h r g g m g G m m g h r h g m G h g m h g g m G h G h G g r m m r G G G G m g h h r m G h g r h r G g h g G h h g g m h G G h h r r h m h g h g G 
m r G m m m m g h h h G m h r h m h g m r r G m r r h g h g h h G G G m g h g g r r r m G G G g r g g m r m r g h h h m m g g r g G r m m r h g G h h r m G h m h r h g G m g g G r r G g m m r g G G h 
h r m g g m m h g m r r r h G r r r g G h h m h h r r r h G g m r G r r h r r g h r g m m r g h r r h h h g G G G m g m m m G m G g m h m m g g h g g G m G h g h h h G g m G h m h r g m m r r g m G m 
g r r h G m g m r r r h G r m G g r h g m h r G G r r g r m h h m m m h r G m G G r r r G G r m r m G g G r G m G G g h G h m m r g h h G m G G r h G G r G g G G h h m g r h m m G r G m h m h G h g g 
h m h m h g h h h m g g m m h h G G g r m h G m h r G G h h h m r m G h m g m h G m g m g h g r G r m h G m h G h h G r g r m G r g m g G g m m g g h g h m G g r m G r r G g m r G r g h G G m m G r h 
m G h g g g g G r r G g h r G h h r m h m G G r G r g r m h G g G m m h g G g g G G g h g g g G G r G r h g G G g m h r G r G g h r g m g m G h h m h m h g G G m m m h h m r h h r m m h r r r m r r h 
g h m G G G h m r g g h h h g m g G h r h r h G g g g g r m r m G r m G h g r m g m m r g m G m r g r h h m m h g g g G G m h m r h G G g r m h G g h g G G r h h G h m G G r G G G g G h m G r g g g G 
h r m m h h h m g r h h r G r r g r h h m g h g m r h G h r h r h h G m m r r h r m r r m m r h m h m g r G h g m g r G g r G m m m h h g g h m r g G G g G r m g m G h m r g r h m h g r g g g m h r r 
m g m r g g m h r G g h g g r h h h r g r g m g G g G h g G G g h h h G h g m m r g h h G h r r g g r r G h G m r G m h g r G G r g h r m h r G h h G G g g h m g r g g r m g m g G G r r h r h r G m G 
g g g g r h G m r m r g h G m r h h m r r G m G g m r h m G h g h g G r m g g h r m g r r g r r h h g G h r r r r m g g g h G G g r h m r m G G g h g G h h m G h h g G r h r r G r m h h G r g r g g r 
g m m g r m m G h G G r G r G m g g h g g h m m g m h G g m g r h r r h h g m g g G m g G G G m r r g h g g g m h h G h G h h r G m h g g r h m G h r g G r r g h m G r h r g g G r G g r h r h g h m G 
h G G G g G g h G g r g h G m r m G r G g r G r h g h m h h m h G G G r g h r g h g r h m r g h m G g m h g G m h g h r m g G h r r r G m G g g g g g m r G g m m h h g m g m m G m G m r m h r r m r h 
g h g m r r h G h m m g m G r g G h h r m r G G m g g G g r r m h h g r g m m G m G g r h g r g r g G g G G r m r g g g r h G r G g r h g h m m G h g m g G h g r g m g g r r r h g g r m r h m r m g m 
r m m h m r r h g r G g G g h m m r G g g g m m r G g G r m g m r g m G g m m g m h G g m g G r r G r r G G r h g g G r G h G m r r G h g h m m r r G G h h g g h m r G h m r m g h m g r g G r h r h r 
m G r G r m G h G r g G m r h m m r g m m m G h r G m m g m g r h r G h m g r r G g m h G m r h G h G m G m G h G r g r m m r r g G r r r g m h G h m m G m G r h m r G g g G g h h h g h m G m g G m m 
r h r h G G g G g h m G r h m m m G h m m r h G r m r r G r G h m r m G m h h G m G r g g G m h g h g m g g m m r h m r G r m h m g r G m m h g G m h r m h m r h g G r h G h G h r r m G h m G r h G r 
g h r g r h g g h g G m g g m G m G m g h m G g r g h m r m g g m g g G h m r g r m g m g h r G r h m g r h g m G g h G h G g m G h r r m G G r G r h m G g h h G g g g G m G r m m g G r m r G G h h m 
G r g G m m h m m g h G h r r h h m h r h h r m g m G g m h G G G g G h G G G m m g r h g G m r G h g g h g h r h m g m h m h m h m h m g g G h r m G h r h g h g m m r r m m h g m G h g h m m G G g G 
g r h r r m m g h r h h m g G r h r G r G m g h m G r g m h m G g m m m r G m r r h G g r r h h r g h r r h m g G m h m h r G g r G r h G h h G g g G g h g h h h g g m G g G r m r m m h h r m G G r h 
m g h g g h r r G G g r g m g m m G m G r m m r h h g m r m r g g h m r g g h h m m m m r G m m G r h G m g h m G m G h h r G g G h r r r r m r r r r r m h G r g G r G g r g h m r m h g g G r r g h g 
r m G m h g G h g g g g G h m m r g g h r G g G h G h r r G r g G h g m h m G h h h r r m r m r G r h m g r m G G r r r h r h g m G m g h h G h g g G G r r G h h h h m r g G m r r r g h m g g m g h G 
m m g g G m m m h m m G r m m r G G r g m g g r g r m h m h r h G g g G G g g G G r h g g m g m m h m G g g r G G h h G G h g g h g g h h r h m m g g m h g r h r g g h G r m G g r G m G G h r m h G m 
g h g r h g G h r h m r G G r r h G G r G G m r h r h G r h G m h g G g G r g g G h r G G G m g m m m m G h G G r r h g m G m g G r m h G G g g h m g G g g h g m g h h h r h r g m g r h m r h h r h g 
m g G g G r m r h g r r h g h m h r G G m G g h h m m m m G r G G g h r m m h m m m G r G h r G G r m g G r h g r G m m h r m h r g r G h h G h g r G m g h m m m g m G r G G h r h g g r h m g G r G m 
G m G r r G G G G g r h g h g G r g h m h r m G r h m r r h h r g g g r G r h h r m G r r r m G r G r G G h g h h h m r h r h m h m r m m r g m G m m m g g G r h G G g g r h g g m m G h G m G h r G G 
h r g g m h G G g G m r h h G m m m m h m h g h G h r G G h G g g h G G g h r G r g h r m r m g r h h g m g g m m h g r g g r G m h g r G G r r h m h h G G G h h m g r g r G r m r g h h g G g r m r r 
g m g G g G h g G h r h g G g G G r r G m m g r m g g h G G r r m h h m G g r g m h h g G G r r m r G g m m r m G G G m m h G r h G r m h G m r r g h G m r r G h m m m m r m h g m m r r g m r r r g g 
h h G r r h G h h h G g G h m G g h G h h r m h G m g r g G h G g g h G h r g h g r m g h G G g r G h g G h r h g g r r r m r G G g g m h r r g G m r G m r r r G G g m r r g m m G G r r g m m G h g G 
m r m r m g m m h r g h r h h g g h h G m r g G h m h r G G r m g h g g G G h h m r h g h r r h r r m m G r G m G m m G g G h r r r h h G g G r G m r r G g r h r G h m g g h h r G h h h h r G r G m g 
G g r G G g g h g r G G h h G G g h r h g G h m G m g h m r r m m G G m g g G r r g m h m g r g m r G h g G h h h G g h g h G r m G G G g m h r m g r h h G g h G G h g G h G G h m h r m r g G r r h g 
g r G r g G g G m m h m g h h G G r h g r m r m G r h m h r r m g h G m g r g G g m G r r G g g G g m r m G h g G g g g m r r h r m g g G G G h m r m m G G h m r m m G g G G m h h m r h m G g G G G G 
m m r r G g h G g r h r m m G g r g G h g m g g h G G h g G g g G m g g h g h g h r g m r G m m G G r m h g r m G g h r g r h g G r r m g G h r g g G h g m h r h g r G G G g h r m r m r h g g m m g g 
h h m m m r r m h g r G g g m G h g m m r r m r g r r r G g h m m h m h h g G m g r r m h r g g h h h g h r m g r m m G g m g m r G G r h m m g h r m G h g h m h m m G G h m h h g h g h h g h r G h r 
g g G g m r m r g G g m h G h r m m G g h h g G r g g h h g h G r m G G G m h h r m r m m m G h G h h G m h g m m m m m g g r r g r g h g h G G G g G h h G g m m m r m G m r m r h G G g G h G g h G m 
g m r h G G h G G h g m g h m m h h g G G r h G m r m m r G h r r r h m G h h G h r G r g G G r g G g g h h m g r r G G h r h r r r h g m m G G m G m h g g h m g m r m m h g r h G r g m g m G G g h h 
G h g m g h G h g r g h g r g r g h g h g g m G r h G h h g g r r G m r r g m h r G h G r r g G g m h m g m G h m G h r r g m G r r r m g h h g G r G r g G r g m G r g G r m G m r r r m m g m G G m h 
h g g g G g G g G m g h r r h h G g g G g G G g m m g r G m m g g G G m m m G g h r g r m m g h m G m h g h r h m m g m g g r m m g r h g G r m h m m g r r m G G h m r G G r g h m h G m G r r m G r G 
G g G h h h m h g h r h r m h m h m r G r G h r m g G g G m r g m G m G g m g h h r G h r g r h G G r r m h h h G g G h r r h g h m g h G G r G G h m r m m r G r G g m m G G m G r h G h m h g m h r r 
m h g m G r g g r g g r h g G m g h r G h G r G h g m G G G m r m h G h r G m m g h G r G h h g G m g g h r h h g m h h h m r m h g g m r m h G g g h m G r m h m G r G g h G g r g h m G r r h g r g g 
g m g m r m r r m h r G m r r r G r g m g r m g m G h m h G g g r m G g g g G g r g r g h r m h G G h g G r g m m m m G h G G g g m h m h h G G m r G g g h g h G G r r g h g h r h h G g G m m m r h m 
G h r m g h m h m r h r g h m r h m g r G h m h G g h G r m r m h r h g h m G h r m m g m m r h m m g g m g h h G r g g m g h g g g g r g h r G h g r h g m r r h r g g G h G r r r G g r g G g g r h G 
r h h h h h G r m G h h g h m G g g h G r h r r m m r m h r h G r r G h g r g G r g r h g G G h G g r r g m m G r g r G g m r m g h h h G g r h m G r G h m g h G G m g h h h r r r r G G h G g G g g g 
G g r g m m r h m h m r h r r G h r G g g G g m r r h g G g h m g m G h g g r G m h G G g h h G g g r r G m g m G G r g G r G G G g g r g r G g g m m h r r m h r h G G m m m r r m h g G h G m r g m r 
r r g m r h m m h g G m h h m r G r r h r G g g m m r g h r G G G g h r h h m G G r h G g G m r r g G m r g h r G G m h G g r m m m g m g G g g h G G h g h m r g G h r m h G g G G m G h m G r g g m h 
m m m h m m g m h m g m G m g m r G G g r r r h g m m G m h m h g r g m h h r m r G h m h h m g G g g m r h m g r m m h g g G G m G G g G G r r r h r h m G r h G r G r G h h g g m r h G g G g G h r g 
m G G r m g g m g r g h g G m g G h g m g G h h r G G m m h h g h g g r r m h r m h r g h G g G r g m h r G m r h g r G m g r r m G G m r m r h r h G h h m m r G G h h g g r G h m G r r g m G g m G G 
G m m g G m G h m r h m h g G G r G g G g h r G h g r m r g G h G g g g h h g r m G m h g g g r r h r r G G G r r g g r h G m m h g r g m G r h r r G r h r r G h h r g h g m m r m h G r G h m m h G m 
h g g h r h g r r G G g G r G g m h r m g m m r G G r m m g g g h r h r m G G r r h g h h g m m h r m h m m m G G G r g r h h m h g G g g g h m m r m h G g h r m m G r m r g r G m g m m h h r g m r g 
h m g r r m m m m r r m G g m G g m h G G m m g r m g G r m r h h m r m r G G g r m m r g r h r h r h h r h g g h r r g g r G G G G m m h h G G m h m G G g g h g h r m g r h m m h G h m r G G G g m r 
h G h g g h h g g r g g h r m h h G g r r G g m G h r G m h m h g G G g G G m g g m m G G h r g G r G m r m G r G h m m m r G G h G g g h g r G m G g m m G r G g m G g r h m G h g m m m r h G m G G g 
h g G g m m r m m G r G m r r G G r G r g G h m r G G m G m G g h h h r h r g g r r m r h m r G h m r g h h m h m r r m g h G G h G h m g g h m r r g g r r g g r G g G G h r r h h G G h h g g G G g m 
G r r m r r r G g G g m G m h m r h m r g h m h m g r m r h h r g m r m r m r G r g m m h r m G h g G g g m h r r g r h h h G g G m m g h r m g m h G G h g r h r m r m h h m m G G r g m m m G h m r r 
0 0
99 99